

              NO               ./textures/no.xpm
         C 50,0,10
F 0,10,    10
        		EA     ./textures/ea.xpm

          SO                 ./textures/so.xpm

            WE      ./textures/we.xpm


111111111
110D1
11111111111N
111111111



