
			F        255,255,255

              NO ./textures/no.xpm
            C                225,30,0
        		EA     ./textures/ea.xpm

          SO                 ./textures/so.xpm

            WE	./textures/no.xpm


1111111
1000001
100N001
1000001
1000011
1100011
1111111
