

              NO               ./textures/no.xpm
         C 50,0,10
F 0,10,10
        		EA     ./textures/ea.xpm

          SO                 ./textures/so.xpm

            WE      ./textures/no.xpm

1111111
1000001
1010101
10N0011
1010001
1111111



