

              NO               ./textures/wall1.xpm
         C 50,0,10
F 0,10,    10
        		EA     ./textures/wall2.xpm

          SO                 ./textures/wall3.xpm

            WE      ./textures/wall4.xpm


1111111
100N001
1000001
100D001
1000001
1111111
