

              NO               ./textures/no.xpm
         C 50,0,10
F 0,10,10
        		EA     ./textures/ea.xpm

          SO                 ./textures/so.xpm

            WE      ./textures/we.xpm

11111111111111
10000W1
1011111
1000011
1010001
1111111

