
			F        255,255,255

              NO ./textures/no.xpm
            C                225,30,0
        		EA     ./textures/empty.xpm

          SO                 ./textures/so.xpm

            WE	./textures/no.xpm


1111111
1000001
100N001
1000001
1    11
11   11
1111111
