
			F        255   ,   255   ,    255

              NO ./textures/no.xpm 
         C        225,    30 ,   0
        		EA     ./textures/ea.xpm

          SO                 ./textures/so.xpm

            WE      ./textures/no.xpm

111111
1N   1
111111



