    
			F        255,255,255  
   
              NO ./textures/no.xpm   
            C                225,30,0			
        		EA     ./textures/ea.xpm       		

          SO                 ./textures/so.xpm 

            WE	./textures/no.xpm



111111111111111110000000000
00000000000111111111
0111111
01000N1
0101010
0111111000
000000000000000000000000000000
 1  
00000000000000000



