C 50,0,10
F 0,10,1

NO ./textures/no.xpm
SO ./textures/so.xpm
WE ./textures/we.xpm
EA ./textures/ea.xpm

1111111111111111111
101000001000000000111
101010101011111110001
100010100010000010001
111110101111101011101
10000010D000D01000001
101111101011101111111
10100000101010000W1
1110111110101111101
 1111   11111111111