C 50,0,10
F 0,10,1

NO ./textures/no.xpm
SO ./textures/so.xpm
WE ./textures/we.xpm
EA ./textures/ea.xpm

1111111111111111111
10W100100D001000001
1011000001000001001
1001001001110101111
100111100000100D001
1000000000000001001
100111111111D101001
11111000000000001011
1000000001000000001
1111111111111111111
