C 50,0,10
F 0,10,10

NO ./textures/no.xpm
SO ./textures/so.xpm
WE ./textures/we.xpm
EA ./textures/ea.xpm


1111111111111111111
10W1001001001000001
101100000D00D001001
1001001001111101111
1001111D10001001001
1000000010000001001
101111111111100D001
111 100001000001011
100100000D000000001
1111111111111111111
1 